Основной творческий коллектив = 
Продюсер = Producer
Режиссер-постановщик = Director
Оператор-постановщик = Director of Photography
Художник-постановщик = Production Designer
Художник по костюмам = Costume Designer
Композитор = 
Музыкальный продюсер = Music Producer
Звукорежиссер = Sound Director
Арт-директор = 
Фотограф = Production Photographer
Группа сценаристов = 
Сценарист = Scriptwriter
Редактор = 
Скрипт-доктор = Script Doctor
Административная группа = 
Сопродюсер = Co-Producer
Креативный продюсер = Creative Producer
Исполнительный продюсер = Executive Producer
Ассистент продюсера = Assistant Producer
Линейный продюсер = Line Producer
Менеджер по площадке = Location Manager
Локейшн-скаут = Location Scout
Администратор на площадке = Production Assistant
Продюсер постпродакшн = 
ТВ-продюсер = 
Режиссерская группа = 
Второй режиссер = First Assistant Director
Помощник режиссера = Second Assistant Director
Режиссер планирования = 
Раскадровщик = Storyboard Artist
Кастинг-директор = Casting Director
Ассистент режиссера по актерам = 
Скрипт супервайзер = Script Supervisor
Технический директор = Technical Director
Коммерческий директор = Commercial Director
Хореограф = Choreographer
Бригадир массовки = Extras Coordinator
Операторская группа = 
Директор съемочной группы
Кинооператор = Camera Operator
1-й Ассистент оператора, фокус-пуллер = 1st AC, Focus Puller
2-й Ассистент оператора, хлопушка = 2nd AC, Clapper loader
Плейбэк = Playback
Оператор стедикам = Steadicam Operator
Оператор дрона/коптера = Drone Operator
Оператор воздушных съёмок = 
POV-оператор = 
Оператор комбинированных съемок = 
Механик камеры = Camera Production Assistant
Видеограф = Cinematographer
Осветительный и постановочный цеха =
Бригадир осветителей = Gaffer
Помощник гафера = Best Boy
Осветитель = 
Инженер по генераторам = Generator Operator
Старший рабочий-механик = Key Grip
Помощник старшего рабочего-механика = Best Boy Grip
Дольщик = Dolly Grip
Оператор крана = Crane Operator
Цех декоративно-технических сооружений =
Декоратор = Set Designer
Установщик декораций, постановщик  = 
Бутафор = 
Реквизитор = Propmaker
Гримерный и костюмерный цеха = 
Костюмер = Costume Supervisor
Ассистент художника по костюмам = Assistant Costume Supervisor
Художник-гример = Makeup Artist
Ассистент художника по гриму = 
Художник по специальному гриму = SFX Makeup
Парикмахер = Hair Stylist
Стилист = Wardrobe Stylist
Оружейно-пиротехнический цех = 
Пиротехник = Special Effect Supervisor
Оружейник = Weapons Master
Трюковая группа = Stunts
Постановщик трюков  = Stunt Coordinator
Каскадёр = Stuntman
Цех монтажа = 
Режиссёр монтажа = Film Editor
Монтажёр = Editor
Цветокоррекция = Color Grading 
Клинап = Clean Up
Визуальные эффекты 
Previs Artist =
Concept Artist = Художник-концептуалист
Modeler = Моделер
Rigger = Риггер
Texture Artist =  
Layout Artist = 
Compositing Supervisor = 
Compositor = Композер
Roto Artist = Художник по ротоскопированию
Matchmover = 
Matte Painter = 
FX TD = Технический директор по специальным эффектам
Pipeline TD =
Lighting TD = 
TD = Технический директор
VFX Producer = Продюсер по визуальным эффектам
CG Producer =
CG Supervisor = Супервайзер компьютерной графики 
VFX Supervisor = Супервайзер визуальных эффектов
CG Generalist = Специалист по компьютерной графике
VFX Artist = Художник по визуальным эффектам
VFX Editor = Монтажер визуальных эффектов
Motion Control Camera Operator = Оператор Motion Control камеры
Flame/Inferno Operator = Оператор Flame/Inferno
Stop Motion Animator = Стоп-моушн аниматор
Animator = Аниматор
Animation Supervisor = Супервайзер анимации
Художник по макетам  = 
Иллюстратор = 
Моушн-дизайнер = Motion Designer
Звукоцех = 
Саунд продюсер = Sound Producer
Звукооператор на площадке = Sound Recordist
Ассистент звукооператора = 
Шумооформитель = Foley Artist
Бум-оператор, микрофонщик = Boom operator
Звукорежиссёр  =  Sound Director
Инженер звукозаписи = Utility Sound Technician
Звукомонтажер, монтаж звука = Sound Editor
Звукорежиссёр перезаписи = Post-production sound mixer